8 9
******..
*p*..**.
*ppp..**
*.*....*
*...*..*
**.....*
.*....**
.*...**.
.*****..
3 4
6
3 3
2 4
3 5
5 5
2 6
4 6
4
