9 9
*****....
*...*....
*...*.***
*...*.*p*
***.***p*
.**....p*
.*...*..*
.*...****
.*****...
2 7
3
2 2
2 3
3 6
3
