20 11
********************
********..*...*...**
**........*.....*.**
**....***.**.*p....*
***.*.....**.p.p...*
*......*.....p*p...*
*......*****p***p***
*..........*ppppp***
*.......**..p**.p.**
*...**..*******...**
********************
1 6
14
4 3
3 4
5 4
3 5
5 5
3 6
6 6
2 7
3 7
4 7
5 7
6 7
2 8
6 8
14
